NO ./assets/normal_north.xpm
SO ./assets/normal_south.xpm
WE ./assets/normal_west.xpm
EA ./assets/normal_east.xpm

F 220,200,0
C 225,30,0

111111111111111111111111111111111111111111111111111111111111
111111101111111111111111111111111111111111111111111111111111
111111101111111111111111111111111111111111111111111111111111
111111101111111111111111111111111111111111111111111111111111
111111101111100000001101111111111111100001111100000000001111
111111101111101111111101111111111111101111111101111111101111
111111101111101111111101111111111111101111111101111111101111
111111100000000000000001111111111111101111100001111101101111
111111101111111111101111111111111111101111101101111101101111
111111101111111111101111111111111111101111101101111101101111
111100001111111111101111111111111111101111101100001101101111
111101111111111111101111111111111111101111101111101101101111
111101111111111111101111111111111111101111101111101101101111
111101111101111100001111111111111111100000001111100001101111
111101111101111101101111111111111111101101101111111101101111
111101111101111101101111111111111111101101101111111101101111
100000000001111100000001111111111111100001100000000000001111
111101111111111111111101111111111111111101111101111111101111
111101111111111111111101111111111111111101111101111111101111
111100001111111111100001111111111111111101100000001100000001
111111101111111111101111111111111111111101101111111111101111
111111101111111111101111111111111111111101101111111111101111
111111100000000000001111111101111111111100000000001111100001
111111111111101111111111111101111111111101111111101111111101
111111111111101111111111111101111111111101111111101111111101
1111111111111000E00D0000000000000000000000001111101100000001
111111111111111111111101111101111101111111111111101101111111
111111111111111111111101111101111101111111111111101101111111
111111111111111111111101111101111101111111111111100001111111
111111111111111111111101111101111101111111111111111111111111
111111111111111111111101111101111101111111111111111111111111
111111100000000000000000000000000001111111111111111111111111
111111111111111111111101111101111101111111111111111111111111
111111111111111111111101111101111101111111111111111111111111
111111111111111111111101111101111101111111111111111111111111
111111111111111111111101111101111101111111111111111111111111
111111111111111111111101111101111101111111111111111111111111
111100000000000000000000000000000000000001111100000000001111
111111111101111111111111111101111111111101111101101111111111
111111111101111111111111111101111111111101111101101111111111
111111111100000001111111111101111111111101111101100000001111
111111111101111101111111111111111111111101111101101111101111
111111111101111101111111111111111111111101111101101111101111
111101111100001100001111111111111111100000000001101111101111
111101111101101111101111111111111111101111111111101111101111
111101111101101111101111111111111111101111111111101111101111
111101111101101111100000000000000000001111111111100000001111
111101111101101111101111111111111101101111111111111111101111
111101111101101111101111111111111101101111111111111111101111
111100000000001100000001111111111100000001101100000001101111
111101101111101101101101111111111111101101101101111101101111
111101101111101101101101111111111111101101101101111101101111
111101101111101101101101111111111111101100000001101100000001
111111101111101111111101111111111111101101111101101111101111
111111101111101111111101111111111111101101111101101111101111
111111100000000000000001111111111111100001111100000000001111
111111111111111111111111111111111111101101111111101111111111
111111111111111111111111111111111111101101111111101111111111
111111111111111111111111111111111111101101111111101111111111
111111111111111111111111111111111111111111111111111111111111

