NO ./assets/normal_north.xpm
SO ./assets/normal_south.xpm
WE ./assets/normal_west.xpm
EA ./assets/normal_east.xpm

M ./sound/imperial.mp3

F 0,100,0
C 0,0,100

11111
10W01
1^001
1^D01
11111
